_ _______________
| _ __|____ __| |
| |__ _ |__ __| |
|__ |_| |__ ____|
| | __| | | | | |
| | _ | | ___ | |
| | |_| _ | | __|
| | __| | __| __|
|_____|_|_|____ |
