_ _______
| _____ |
| | | _ |
| |___| |
|_____| |
